 a=неопределенный артикль, один из
 ability=способность, умение
 able=способный, обладающий способностью
 about=насчет, на тему, повсюду
 above=вверху, наверх, над
 abroad=за границей, за границу
 absence=отсутствие
 absent=отсутствующий, отсутствовать
 absolutely=абсолютно, совершенно
 accept=принимать, признавать
 accident=авария, случай
 according=согласно, в соответствии с
 account=счет, расчет, отчитываться
 achieve=достигать, добиваться
 acid=кислота, кислотный
 across=поперек, через, поперек
 act=действовать, поступать, действие
 action=действие, поступок
 active=активный
 activity=деятельность, активность
 actor=актер
 actual=фактический, настоящий
 actually=на самом деле, фактически
 add=прибавлять, присоединять
 addition=дополнение
 address=адрес, обращаться
 adjective=прилагательное
 admire=восхищаться, любоваться
 admit=допускать, принимать
 adult=взрослый, для взрослых, взрослый
 advanced=передовой, продвинутый
 advantage=преимущество
 adventure=приключение
 adverb=наречие
 advertisement=реклама, рекламное объявление
 advice=совет, рекомендация
 advise=советовать, консультировать(ся)
 affair=дело, роман
 affect=влиять, затрагивать
 afford=позволить себе, быть в состоянии
 afraid=боящийся, испуганный
 after=после, за, после того как
 afternoon=после полудня, дневное время
 again=опять, ещё
 against=против, перед
 age=возраст, век, стареть
 agency=агентство
 ago=тому назад
 agree=соглашаться
 agreement=соглашение, договор
 ahead=впереди, вперед, будущий
 aim=цель, задача, целиться
 air=воздух, атмосфера, проветривать
 airplane=самолет
 airport=аэропорт
 alcohol=алкоголь
 alive=живой
 all=все, все
 allow=позволять, разрешать
 almost=почти
 alone=одинокий, единственный, в одиночестве
 along=вдоль, по, вдоль
 alphabet=алфавит
 already=уже
 also=также, тоже
 although=хотя, несмотря на то, что
 always=всегда
 among=между, среди
 amount=количество, сумма, составлять
 amuse=развлекать, забавлять
 amusing=забавный, занимательный
 ancient=античный, древний
 and=и
 anger=гнев, злость
 angle=угол
 angry=сердитый, рассерженный
 animal=животное, животный
 announce=объявлять, анонсировать
 annoy=раздражать
 another=другой, иной, другой
 answer=ответ, отвечать
 anxiety=тревога
 anxious=тревожный, озабоченный
 any=сколько-нибудь, кто-нибудь
 anybody=любой, кто-нибудь
 anymore=больше не, уже не
 anyone=любой, кто-угодно
 anything=что-нибудь, что угодно
 anywhere=где угодно, везде
 apart=отдельно, врозь
 apartment=квартира, апартаменты
 appear=показываться, появляться
 appearance=внешний вид, появление
 apple=яблоко
 appropriate=подходящий, соответствующий
 approval=одобрение
 approve=одобрять, утверждать
 April=апрель
 area=пространство, область
 argue=спорить, утверждать
 argument=аргумент, довод
 arm=рука, вооружать
 army=армия, войска
 around=вокруг, около, вокруг
 arrange=организовывать, расставлять
 arrangement=соглашение, договоренность
 arrival=прибытие
 arrive=прибывать, приезжать
 art=искусство
 article=статья, вещь
 artificial=искусственный
 artist=художник, артист
 as=как, в качестве, как
 ashamed=пристыженный
 ask=спрашивать
 asleep=спящий
 association=ассоциация, объединение
 at=у, за
 atom=атом, мельчайшая частица
 attach=прикреплять(ся), присоединять(ся)
 attack=атаковать, нападать, атака
 attempt=попытка, покушение, пытаться
 attend=посещать, присутствовать
 attention=внимание
 attitude=отношение, позиция
 attract=привлекать, притягивать
 attractive=привлекательный
 August=август
 aunt=тетя
 author=автор
 authority=власть, органы власти
 autumn=осень
 available=доступный
 average=средний, обыкновенный, среднее
 avoid=избегать
 awake=просыпаться, будить, бодрствующий
 away=далеко, вдали
 awkward=неловкий, неуклюжий
 baby=ребенок, младенец, детский
 back=назад, обратно, задний
 background=фон, происхождение
 bad=плохой, несчастье
 badly=скверно, плохо
 bag=сумка, мешок
 bake=печь(ся), выпекать(ся)
 balance=баланс, равновесие, (с)балансировать
 ball=мяч, шар
 band=банда, лента
 bank=банк, берег (реки), банковский
 bar=бар, брусок, преграждать
 base=основа, базис, базировать
 basic=базовый, основной
 basket=корзина
 basketball=баскетбол
 bath=ванна, купать
 battle=битва, сражение, сражаться
 be=быть, существовать
 beach=пляж
 beak=клюв
 beam=луч, излучать
 bean=боб, фасоль
 bear=носить, переносить, медведь
 beard=борода
 beat=бить, удар
 beautiful=красивый, прекрасный
 beauty=красота
 because=потому что
 become=становиться, случаться
 bed=кровать, укладывать спать
 beer=пиво
 before=до, раньше, прежде
 begin=начинать
 beginning=начало
 behave=вести себя
 behavior=поведение
 behind=сзади, за, сзади
 belief=вера, убеждение
 believe=верить
 bell=колокол, звонок
 belong=принадлежать
 below=ниже, ниже
 belt=ремень, пояс
 bend=сгибать(ся), поворачивать, изгиб
 beneath=под, внизу
 benefit=польза, выгода, извлекать пользу
 beside=рядом с, около
 best=самое лучшее, лучший
 better=лучший, более подходящий, лучше
 between=между, между
 beyond=за, вне, за пределами
 bicycle=велосипед
 big=большой
 bird=птица
 birth=рождение, роды
 bite=кусать(ся), укусить, укус
 black=черный, черный цвет
 blade=лезвие, клинок
 blame=обвинять, порицать, вина
 blind=слепой
 block=блокировать, блок
 blood=кровь
 blow=дуть, порыв ветра
 blue=синий, голубой, синий цвет
 board=доска
 boat=лодка
 body=тело, туловище
 boil=кипятить(ся), кипение
 bomb=бомба, бомбить
 bone=кость
 book=книга, бронировать
 boot=ботинок, сапог
 border=граница
 boring=скучный
 borrow=брать в долг
 both=оба, как..., так и
 bottle=бутылка
 bottom=низ, нижний
 bowl=кубок, чаша
 box=коробка, ящик, боксировать (бить кулаком)
 boy=мальчик
 brain=мозг
 branch=ветвь, ответвление
 brave=храбрый, смелый
 bread=хлеб
 break=ломать, перерыв
 breakfast=завтрак
 breast=грудь
 breath=дыхание, вздох
 breathe=дышать
 brick=кирпич
 bridge=мост
 bright=яркий, блестящий, ярко
 bring=приносить, приводить
 broad=широкий, обширный, широко
 broadcast=трансляция (радио, теле), вещание, вещать
 brother=брат
 brown=коричневый, бурый, коричневый цвет
 brush=щетка, кисть, чистить (щеткой)
 bucket=ведро
 build=строить
 building=здание
 bullet=пуля
 bunch=связка, гроздь
 burn=гореть, сжигать, ожог
 burst=взрыв, взрываться
 bury=хоронить, закапывать
 bus=автобус
 bush=куст, кустарник
 business=дело, бизнес
 busy=занятой, занятый
 but=но, лишь
 butter=масло
 button=кнопка, пуговица
 buy=покупать, покупка
 by=у, возле, около, к, не позже чем
 bye=пока, до свидания
 cake=торт, пирожное
 call=вызывать, окликать, звонок
 calm=спокойный, тихий, спокойствие
 camera=фотоаппарат, камера
 camp=лагерь, располагаться лагерем
 can=мочь, уметь
 candy=конфета, леденец
 cap=кепка, фуражка
 capital=столица, капитал, заглавный
 car=автомобиль, машина
 card=карта
 care=заботиться, ухаживать, уход
 careful=осторожный, внимательный
 carry=нести, носить, переноска
 case=случай, обстоятельство
 castle=замок, дворец
 cat=кошка, кот
 catch=поймать, ловить, поимка
 cause=причина, основание, вызывать
 ceiling=потолок
 celebrate=праздновать
 cell=клетка, ячейка
 cent=цент
 center=центр, середина чего-л., центрировать
 centimeter=сантиметр
 central=центральный, главный
 century=век, столетие
 ceremony=церемония
 certain=определенный, точный
 chair=стул, кресло, возглавлять
 chance=шанс, случайность, случайный
 change=менять, меняться, перемена
 character=характер, персонаж
 charge=плата, ответственность, обвинять
 cheap=дешевый, недорогой, дешево
 cheat=жульничать, обманывать, мошенничество
 check=проверять, проверка
 cheek=щека, нахальство
 cheerful=веселый, радостный
 cheese=сыр
 chemical=химический, химический продукт
 chemistry=химия
 chest=грудная клетка, сундук
 chicken=курица
 chief=главный, ведущий, начальник
 child=ребенок
 chin=подбородок
 chocolate=шоколад, шоколадный
 choice=выбор
 choose=выбирать
 church=церковь, церковный
 cigarette=сигарета
 circle=круг
 citizen=гражданин
 city=город
 claim=требовать, утверждать, требование
 class=класс
 clay=глина
 clean=чистый, чистить
 clear=ясный, чистый, очистить
 clearly=ясно, очевидно
 clerk=клерк, офисный служащий
 clever=умный, способный
 climb=взбираться, карабкаться
 clock=часы
 close=закрывать, закрываться, близко
 cloth=ткань, скатерть
 clothes=одежда
 clothing=одежда
 cloud=облако, туча
 club=клуб, дубинка
 coast=побережье, берег
 coat=пальто, пиджак
 coffee=кофе
 coin=монета
 cold=холодный, холод
 collect=собирать, коллекционировать
 collection=коллекция
 college=колледж, университет
 color=цвет, цветной
 comb=гребень, расческа, расчесывать
 combination=комбинация, сочетание
 combine=сочетать(ся), объединять
 come=приходить, прибывать
 comfort=комфорт, удобства, подбадривать
 comfortable=удобный, комфортный
 command=команда, приказ, приказывать
 common=общий, простой
 communicate=сообщать, общаться
 communication=коммуникация, информация
 company=компания, фирма
 compare=сравнивать
 compete=соревноваться, конкурировать
 competition=соревнование, конкуренция
 complain=(по)жаловаться
 complete=завершать, заканчивать, полный
 completely=совершенно, полностью
 complicated=сложный, запутанный
 computer=компьютер, компьютерный
 concern=беспокойство, забота, беспокоиться
 concerning=относительно, касательно
 concert=концерт
 condition=состояние, положение, обусловливать
 confidence=уверенность, доверие
 confident=уверенный
 confuse=путать, сбивать с толку
 connect=соединять, подключать
 connection=связь, соединение
 conscience=совесть
 conscious=сознательный, сознающий
 consider=рассматривать, обдумывать
 consist=состоять (из), заключаться в
 contain=содержать, сдерживать
 container=контейнер, сосуд
 continue=продолжать
 continuous=непрерывный, постоянный
 contract=контракт, договор, сокращать(ся)
 control=контроль, регулирование, контролировать
 convenient=удобный, подходящий
 conversation=разговор, беседа
 cook=готовить, повар
 cookie=печенье
 cool=прохладный, спокойный, охлаждать(ся)
 copy=копировать, копия
 corner=угол, загонять в угол
 correct=правильный, верный, исправлять
 cost=стоить, цена
 cough=кашлять
 count=считать, подсчитывать, вычисление
 country=страна, провинция, сельский
 courage=храбрость, мужество
 course=курс, направление, струиться
 court=суд, судебное заседание
 cover=покрывать, накрывать, крышка
 cow=корова
 crack=трещина, треск, трещать
 crash=крах, крушение, разбивать(ся)
 crazy=сумасшедший, безумный, сумасшедший
 cream=крем, сливки, кремовый
 create=создавать, порождать
 creature=существо, создание
 crime=преступление, преступность
 criminal=преступный, криминальный, преступник
 criticize=критиковать
 crop=с.-х. культура, урожай
 cross=пересекать(ся), крест
 crowd=толпа, множество, толпиться
 cruel=жестокий
 crush=(раз)давить, дробить
 cry=плакать, кричать, плач
 culture=культура
 cup=чашка, чаша
 cupboard=шкаф, буфет
 cure=лечить, исцелять, лечение
 curl=локон, завиток, виться
 current=текущий, действующий, течение
 curtain=занавес(ка), штора
 curve=кривая, изгиб, изгибать(ся)
 customer=клиент, покупатель
 cut=резать, разрезать, разрезание
 daily=ежедневный, ежедневно
 damage=повреждение, ущерб, повреждать
 dance=танцевать, танец
 danger=опасность
 dangerous=опасный
 dare=сметь, отваживаться, вызов
 dark=темный, черный, темнота
 date=дата, день, датировать(ся)
 daughter=дочь
 day=день, сутки
 dead=мертвый, умерший, покойник
 deal=дело, сделка, иметь дело
 death=смерть
 debt=долг, задолженность
 December=декабрь
 decide=решать, принимать решение
 decision=решение, определение
 decrease=снижать(ся), уменьшать(ся), снижение
 deep=глубокий, глубоко
 defeat=наносить поражение, побеждать, поражение
 defence=защита
 defend=защищать(ся)
 degree=степень, градус
 delay=медлить, задерживать, задержка
 delicate=деликатный, тонкий
 deliver=доставлять
 demand=требование, спрос, требовать
 department=отдел, департамент
 depend=зависеть, рассчитывать
 depth=глубина
 describe=описывать
 description=описание
 desert=пустыня, пустынный
 deserve=заслуживать, быть достойным
 design=дизайн, замысел, проектировать
 desire=желание, желать
 desk=письменный стол, парта
 despite=несмотря на, злоба
 destroy=уничтожать, разрушать
 detail=деталь, подробность, детализировать
 determination=решительность, решение
 determine=определять, устанавливать
 develop=развивать, разрабатывать
 dictionary=словарь
 die=умирать
 difference=разница, отличие
 different=другой, иной
 difficult=трудный, тяжелый
 difficulty=трудность
 dig=копать, рыть
 dinner=обед
 direct=прямой, направлять
 direction=направление, руководство
 director=директор, руководитель
 dirt=грязь
 dirty=грязный
 disappoint=разочаровывать
 discover=открывать, обнаруживать
 discovery=открытие
 discuss=обсуждать
 discussion=дискуссия, обсуждение
 disease=болезнь, заболевание
 disgusting=отвратительный
 dish=блюдо
 dismiss=распускать, увольнять
 distance=дистанция, расстояние
 divide=делить(ся), разделять(ся)
 do=делать
 doctor=врач, доктор, лечить
 document=документ, документировать
 dog=собака
 dollar=доллар
 door=дверь
 double=двойной, удваивать(ся)
 doubt=сомнение, сомневаться
 down=вниз
 draw=рисовать, чертить, ничья
 dream=мечта, сон, мечтать
 dress=платье, одежда, одевать(ся)
 drink=пить, напиток
 drive=ехать, вести, езда
 drop=ронять, капать, падение
 drug=лекарство, наркотик, давать наркотики
 drum=барабан
 drunk=пьяный
 dry=сухой, сушить(ся)
 duck=утка
 due=обусловленный, должный
 dull=тупой, глупый
 during=во время, в течение
 dust=пыль, вытирать пыль
 duty=долг, обязанность
 each=каждый, каждый
 ear=ухо
 early=ранний, рано
 earn=зарабатывать
 earth=земля
 east=восток, восточный
 eastern=восточный
 easy=легкий, нетрудный, легко
 eat=есть, кушать
 economic=экономический, экономичный
 economy=экономика, экономичность, экономичный
 edge=край, грань
 educate=воспитывать, обучать
 education=образование, обучение
 effect=эффект, результат, осуществлять
 effective=эффективный
 effort=усилие, попытка
 egg=яйцо
 eight=восемь, восьмерка
 eighteen=восемнадцать
 eighty=восемьдесят
 either=или, любой из двух
 elbow=локоть
 elect=избирать, выбирать
 election=выборы
 electric=электрический
 electricity=электричество
 electronic=электронный
 eleven=одиннадцать
 else=еще, кроме
 embarrass=смущать, стеснять
 emotion=эмоция, волнение
 emphasize=подчеркивать, акцентировать
 employ=нанимать, применять
 employee=сотрудник, работник
 empty=пустой
 encourage=поощрять
 end=конец, кончать
 enemy=враг, противник
 energy=энергия
 engine=двигатель, машина
 engineer=инженер, механик, проектировать
 English=английский язык, англичане, английский
 enjoy=наслаждаться, получать удовольствие
 enough=достаточный, достаточно
 enter=входить, вводить
 entertain=развлекать
 entire=весь, целый
 entrance=вход
 envelope=конверт
 environment=окружающая среда, окружение
 equal=равный, одинаковый, равняться
 equipment=оборудование, снаряжение
 escape=побег, бегство, бежать (из заключения)
 especially=особенно, в особенности
 establish=учреждать, устанавливать
 even=даже, плоский
 evening=вечер
 event=событие, происшествие
 ever=всегда, вечно
 every=каждый, любой
 everybody=всякий, каждый
 everyone=каждый, все
 everything=все
 everywhere=везде, всюду
 evidence=доказательства, данные, свидетельствовать
 evil=зло, злой
 exact=точный
 exactly=точно, именно
 examine=исследовать, изучать
 example=пример
 excellent=отличный
 except=кроме, за исключением того, что
 exchange=обмен, обменивать
 exciting=захватывающий, волнующий
 excuse=извинять(ся), извинение
 exercise=упражнение, осуществлять
 exist=существовать, быть
 existence=существование, бытие
 expect=ждать, ожидать
 expensive=дорогой
 experience=опыт, опытность, испытывать
 expert=эксперт, специалист, экспертный
 explain=объяснять, разъяснять
 explanation=объяснение, разъяснение
 explode=взрывать(ся)
 explosion=взрыв, вспышка
 express=выражать, высказывать, экспресс (поезд)
 expression=выражение
 extreme=крайний, экстремальный
 eye=глаз
 face=лицо, встречаться
 fact=факт, явление
 factor=фактор
 factory=завод, фабрика
 fail=терпеть неудачу, подводить, неудача
 failure=провал, неудача
 fair=честный, справедливый
 fairly=довольно-таки, достаточно
 faith=вера
 fall=падать, падение
 false=ложный
 familiar=знакомый, привычный
 family=семья
 famous=известный, знаменитый
 far=далекий, далеко
 farm=ферма
 farmer=фермер
 fashion=мода
 fashionable=модный
 fast=быстрый, быстро
 fat=жир, жирный
 father=отец
 fault=вина, ошибка
 favor=одолжение, благосклонность
 favorite=любимый, фаворит
 fear=страх, боязнь, страшиться
 feather=перо
 feature=особенность, черта, показывать
 February=февраль
 feed=кормить(ся)
 feel=чувствовать, ощущать
 feeling=чувство, ощущение
 female=женщина, женский
 fence=забор, ограда
 fever=жар, лихорадка
 few=немного, несколько, незначительное число
 field=поле, область, полевой
 fifteen=пятнадцать
 fifty=пятьдесят, 50
 fight=драться, сражаться, бой
 figure=фигура, внешний вид, изображать
 fill=заполнять, наполнять
 film=фильм, снимать фильм
 final=финальный, последний
 finally=в конце концов, наконец
 financial=финансовый
 find=находить, встречать
 fine=прекрасно, хорошо, прекрасный
 finger=палец
 finish=заканчивать, завершать, конец
 fire=огонь, пожар, стрелять
 firm=твердый, крепкий, фирма
 fish=рыба, рыбачить
 fit=подходить, соответствовать, в хорошей форме
 five=пять
 fix=исправлять, фиксировать
 flag=флаг
 flame=пламя
 flat=плоский, ровный, квартира
 flight=полет, рейс
 float=плыть на поверхности, всплывать
 floor=пол, этаж
 flow=поток, течение, течь
 flower=цветок
 fly=летать, муха
 fold=складывать, складка
 follow=следовать, идти за
 food=еда, пища
 foot=ступня
 football=футбол
 for=для, за, ибо
 forbid=запрещать
 force=сила, заставлять
 foreign=иностранный, зарубежный
 forest=лес, лесной
 forever=(на)всегда, (на)вечно
 forget=забывать
 forgive=прощать
 fork=вилка, вилы
 form=форма, вид, формировать
 formal=формальный, официальный
 former=бывший, предшествующий
 forty=сорок
 forward=вперед, дальше, передний
 four=четыре
 fourteen=четырнадцать
 frame=рамка, рама
 free=свободный, бесплатный, свободно
 freedom=свобода
 freeze=замерзать, замораживать, мороз
 frequent=частый
 fresh=свежий
 Friday=пятница
 friend=друг
 friendly=дружелюбный, дружественный
 frightening=пугающий
 from=от, из
 front=передний, перед
 fruit=фрукт(ы)
 full=полный, целый
 fun=веселье, веселый
 funeral=похороны
 funny=смешной, забавный
 fur=мех
 furniture=мебель
 further=дальнейший, далее
 future=будущее, будущий
 gain=получать, приобретать, прирост
 game=игра, играть
 garden=сад
 gas=газ, горючее
 gate=ворота, калитка
 gather=собирать(ся)
 general=общий, обычный, генерал
 generally=обычно, как правило
 generous=щедрый, великодушный
 gentle=нежный, легкий
 get=получить
 gift=подарок, дар, дарить
 girl=девочка
 give=дать, передать
 glad=довольный
 glass=стекло, стакан, стеклянный
 global=глобальный
 glue=клей, клеить(ся)
 go=идти
 goal=цель, задача
 god=Бог, божество
 gold=золото, золотой
 good=хороший
 goodbye=до свидания!
 govern=управлять, править
 government=государство, правительство
 grade=класс, оценка, сортировать
 gradual=постепенный
 grain=зерно
 gram=грамм
 grand=великий, большой
 grandfather=дедушка
 grandmother=бабушка
 grandparent=бабушка или дедушка
 grass=трава
 grateful=благодарный, признательный
 grave=могила, серьезный
 gray=серый, седой, серый цвет
 great=огромный, большой
 green=зеленый, зеленый цвет
 ground=земля, грунт, заземлять
 group=группа, группировать
 grow=расти, произрастать
 growth=рост
 guard=охрана, охранять
 guess=гадать, догадываться, предположение
 guest=гость, гостить
 guide=путеводитель, гид, вести
 guilty=виновный, виноватый
 gun=пистолет, пушка
 habit=привычка, обычай
 hair=волосы
 half=половина, наполовину
 hall=зал, холл
 hammer=молот(ок)
 hand=рука
 handle=ручка, рукоять, обращаться
 hang=вешать, висеть
 happen=случаться, происходить
 happy=счастливый, довольный
 hard=трудный, твёрдый, жестко
 hardly=вряд ли, едва ли
 harm=вред, вредить
 harmful=вредный
 hat=шапка, шляпа
 hate=ненавидеть, ненависть
 have=иметь, обладать
 he=он
 head=голова, возглавлять
 health=здоровье
 healthy=здоровый
 hear=слышать
 heart=сердце
 heat=тепло, жара, нагревать (ся)
 heaven=небеса, небо
 heavy=тяжелый
 heel=пятка, каблук
 height=высота, рост
 hello=привет, здравствуйте
 help=помощь, помогать
 helpful=полезный
 here=здесь, тут
 herself=себя, сама
 hi=привет
 hide=скрывать(ся)
 high=высоко, высокий
 hill=холм
 himself=сам, себя
 history=история
 hit=ударять, поражать, удар
 hold=держать, удерживать
 hole=дыра, отверстие
 holiday=праздник, отпуск
 holy=священный, святой
 home=дом, дома
 honest=честный
 honor=честь
 hope=надеяться, надежда
 horn=рог
 horse=лошадь
 hospital=больница, госпиталь
 hot=горячий, жаркий, горячо
 hotel=отель, гостиница
 hour=час
 house=дом, жилище
 how=как
 however=как бы ни, однако
 huge=огромный
 human=человек, человеческий
 hundred=сто, сотня
 hungry=голодный
 hunt=охотиться, охота
 hurry=спешка, торопить(ся)
 hurt=болеть, повредить, боль
 husband=муж, супруг
 I=я
 ice=лед, ледяной
 idea=идея, мысль
 if=если
 ignore=игнорировать
 ill=больной
 illness=болезнь
 image=изображение, образ
 imagination=воображение
 imagine=воображать, представлять
 immediate=немедленный, ближайший
 immediately=немедленно
 importance=важность, значимость
 important=важный, значительный
 impressive=впечатляющий
 improve=улучшать(ся), совершенствовать(ся)
 improvement=улучшение, совершенствование
 in=в, внутри, внутри
 inch=дюйм, 2,54 см
 include=включать в себя
 including=включая
 income=доход, прибыль
 increase=возрастать, увеличивать(ся), увеличение
 indeed=в самом деле, действительно
 independent=независимый, самостоятельный
 individual=индивидуальный, отдельный, индивид
 industry=индустрия, промышленность
 infection=инфекция, заражение
 influence=влияние, влиять
 inform=сообщить, информировать
 information=информация
 injure=ранить, повредить
 injury=травма, повреждение
 inner=внутренний
 insect=насекомое
 inside=внутри, в
 instead=вместо, взамен
 institution=учреждение, организация
 instruction=инструкция, указание
 instrument=инструмент
 insult=оскорбление, оскорблять
 insurance=страхование, страховка
 intelligent=интеллектуальный, умный
 intend=намереваться
 intention=намерение
 interest=интерес, выгода, интересовать
 interesting=интересный
 international=международный, интернациональный
 interrupt=прерывать, перебивать
 into=в, внутрь
 introduce=представлять, вводить
 introduction=введение, представление кого-л.
 invent=изобретать, придумывать
 invitation=приглашение
 invite=приглашать
 involve=вовлекать, включать
 iron=железо, утюг, железный
 island=остров
 issue=проблема, пункт
 it=это
 itself=сам, себя
 January=январь
 job=работа
 join=соединять, присоединиться
 joke=шутка, шутить
 judge=судить, судья
 judgment=суждение, заключение суда
 juice=сок
 July=июль
 jump=прыгать, прыжок
 June=июнь
 just=точно, как раз, справедливый
 justice=справедливость, правосудие
 keep=держать, хранить
 key=ключ, клавиша, ключевой
 kick=пинать, ударять ногой, пинок
 kid=ребенок, дурачить
 kill=убивать
 kilogram=килограмм
 kilometer=километр
 kind=добрый, любезный, сорт
 king=король
 kiss=поцелуй, целовать
 kitchen=кухня
 knee=колено
 knife=нож
 knock=стучать(ся), стук
 knot=узел, завязывать узел
 know=знать
 knowledge=знание
 lack=нехватка, отсутствие, нуждаться
 lady=леди, дама
 lake=озеро
 lamp=лампа
 land=земля, высаживаться
 language=язык
 large=большой, крупный
 last=последний, продолжаться
 late=поздний, поздно
 laugh=смеяться, смех
 law=закон, право
 lawyer=адвокат, юрист
 layer=слой, класть слоями
 lazy=ленивый
 lead=вести, сопровождать, лидерство
 leader=лидер, руководитель
 leaf=лист
 learn=учиться, учить
 least=менее всего, минимальное количество
 leather=кожа, кожаный
 leave=покидать, оставлять
 left=левый, левая сторона
 leg=нога
 legal=легальный, законный
 lend=давать взаймы, одалживать
 length=длина
 less=меньше, менее, меньший
 lesson=урок
 let=позволять, разрешать
 letter=письмо, буква
 level=уровень, степень, плоский
 library=библиотека
 lid=крышка, веко
 lie=лежать, лгать, ложь
 life=жизнь
 lift=поднимать(ся), подъем
 light=светить, освещать, свет
 like=любить, нравиться, подобно
 likely=вероятно, вероятный
 limit=ограничивать, предел
 line=линия, черта
 lip=губа
 liquid=жидкость, жидкий
 list=список, перечень, перечислять
 listen=слушать
 liter=литр
 literature=литература
 little=маленький, немного
 live=жить, живой
 load=загружать, грузить(ся), груз
 loaf=буханка, батон
 local=местный, локальный, местный (житель)
 lock=запирать, замок
 lonely=одинокий
 long=длинный, долго
 look=смотреть, глядеть, взгляд
 lose=терять, утрачивать
 loss=потеря, утрата
 lot=много, уйма, намного
 loud=громкий, громко
 love=любовь, любить
 low=низкий, невысокий, низко
 loyal=лояльный, верный
 luck=удача
 lucky=удачливый, удачный
 lung=легкое
 machine=машина, машинный
 magazine=журнал
 magic=магия, волшебство
 mail=почта, посылать по почте
 main=главный, основной
 major=основной, главный, майор
 make=делать, создавать
 male=мужчина, самец, мужской
 man=мужчина, человек
 manage=управлять, справляться
 manager=менеджер, управляющий
 many=многие, много, масса
 map=карта
 March=март
 mark=знак, отметка, помечать
 market=рынок
 marriage=брак, замужество
 married=женатый, замужняя
 marry=жениться, выходить замуж
 mass=масса, массовый
 match=соответствовать, совпадать, матч, спичка
 material=материал, вещество, материальный
 mathematics=математика
 matter=вещество, вопрос, иметь значение
 may=быть вероятным, мочь
 May=май
 maybe=может быть
 meal=принятие пищи, еда
 mean=иметь в виду, подразумевать, неприятный
 meaning=смысл, значение
 means=средство, способ
 measure=измерять, оценивать, мера
 meat=мясо
 media=СМИ, масс-медиа
 medical=медицинский
 medicine=медицина, лекарство
 meet=встречать, встречаться
 meeting=собрание, встреча
 melt=плавить(ся), таять
 member=участник, член группы
 memory=память, воспоминание
 mental=психический, умственный
 mention=упоминать, упоминание
 mess=беспорядок, путаница, пачкать
 message=сообщение, послание, посылать сообщение
 metal=металл, металлический
 meter=метр
 method=прием, метод
 middle=середина, средний
 might=мощь, могущество
 mile=миля, 1609 метров
 military=военный, воинский, военные
 milk=молоко
 million=миллион
 mind=разум, ум, иметь в виду
 mine=шахта, рудник
 mineral=минерал, руда, минеральный
 minister=министр
 minute=минута
 mirror=зеркало
 miss=скучать, упускать, пропускать, потеря
 mistake=ошибка, ошибаться
 mix=смешивать(ся), сочетать(ся), смесь
 mixture=смесь
 model=модель, образец, моделировать
 modern=современный
 moment=момент
 Monday=понедельник
 money=деньги
 monkey=обезьяна
 month=месяц
 mood=настроение
 moon=луна
 moral=моральный, нравственный, мораль
 more=еще, больше
 morning=утро
 most=наиболее, самый большой
 mother=мать
 motor=мотор, двигатель
 mountain=гора
 mouse=мышь
 mouth=рот
 move=передвигать, двигаться, движение
 movement=движение
 movie=кино, фильм
 movie=кино
 much=весьма, очень
 mud=грязь
 multiply=умножать(ся), увеличивать(ся)
 murder=убийство, убивать
 muscle=мышца, мускул
 music=музыка
 musician=музыкант
 must=должен, обязан, необходимость
 myself=сам, себя
 mysterious=таинственный, загадочный
 mystery=тайна, таинство
 nail=гвоздь, ноготь, прибивать (гвоздями)
 name=имя, название, называть
 narrow=узкий
 nation=народ, нация
 national=национальный, гражданин
 natural=естественный, натуральный
 nature=природа, сущность
 navy=военно-морской флот
 near=возле, около, недалеко
 nearly=близко, около
 neat=опрятный, чистый
 necessary=необходимый, необходимо
 neck=шея
 need=нуждаться, необходимость
 needle=игла, иголка
 negative=отрицательный, негативный
 neither=ни один, никто (из двух), тоже не
 nerve=нерв
 nervous=нервный, нервничающий
 nest=гнездо, гнездиться
 net=сеть
 network=сеть
 never=никогда
 new=новый
 news=новости
 newspaper=газета
 next=следующий, затем
 nice=хороший, приятный
 night=ночь
 nine=девять, девятка
 nineteen=девятнадцать
 ninety=девяносто
 no=нет, не, никакой
 nobody=никто
 noise=шум
 none=никто, ни один
 nonsense=ерунда, вздор
 nor=ни
 normal=нормальный, обычный
 north=север, северный
 northern=северный
 nose=нос
 not=не, нет
 note=заметка, записка, замечать
 nothing=ничто, ничто
 notice=замечать, внимание
 noun=существительное
 November=ноябрь
 now=сейчас, в настоящий момент
 nowhere=нигде, никуда
 number=число, нумеровать
 nurse=медсестра, сиделка
 nut=орех, чудак
 obey=повиноваться, слушаться
 object=объект, предмет, возражать
 obtain=получать
 occasion=случай, повод
 ocean=океан
 October=октябрь
 odd=странный, нечетный
 of=указывает на отношение принадлежности
 off=указывает на дистанцию, выключение, дальний
 offend=оскорблять, нарушать что-л.
 offense=правонарушение, оскорбление
 offensive=оскорбительный, наступательный
 offer=предлагать, предложение
 office=офис, служба
 officer=офицер, полицейский
 official=официальный, служебный, должностное лицо
 often=часто
 oil=масло, нефть, смазать
 OK=хорошо, ладно, в порядке
 old=старый
 on=на
 once=раз, однажды, один раз
 one=один, один
 onion=лук
 only=единственный, только
 onto=на
 open=открытый, открывать
 operate=работать, действовать
 operation=операция, действие
 opinion=мнение
 opponent=оппонент, противник
 opportunity=возможность, удобный случай
 oppose=выступать против, противодействовать
 opposite=противоположный, обратный, напротив
 opposition=оппозиция, сопротивление
 option=вариант, выбор
 or=или
 orange=апельсин, оранжевый цвет, оранжевый
 order=порядок, приказ, приказывать
 ordinary=обычный, обыкновенный
 organ=орган
 organization=организация
 organize=организовывать, устраивать
 origin=начало, происхождение
 original=оригинальный, первоначальный , оригинал
 other=другой, иной, другой
 ought=(+ to) должен
 ourselves=себя, собой
 out=вне, снаружи, из
 outdoor=наружный, внешний
 outer=внешний, наружный
 outside=вне, снаружи, внешний
 over=через, за, через
 owe=задолжать, быть должным
 own=свой, собственный, владеть
 owner=владелец
 pack=упаковывать, собирать, упаковка
 package=пакет, сверток, упаковывать
 page=страница
 pain=боль, причинять боль
 painful=болезненный, мучительный
 paint=краска, рисовать (красками)
 painting=картина, живопись
 pair=пара, образовывать пару
 pale=бледный
 pan=кастрюля, сковорода
 pants=брюки, штаны
 paper=бумага
 parallel=параллельный, параллель
 parent=родитель, предок
 park=парк, парковать(ся)
 part=часть, доля
 particular=конкретный, особый
 partly=частично, отчасти
 partner=партнер
 party=партия, группа
 pass=проходить, сдавать, проход
 passage=проход, коридор
 passenger=пассажир
 past=прошлое, прошлый
 path=путь, дорожка
 patience=терпение
 patient=терпеливый, пациент
 pattern=образец, шаблон
 pause=пауза, делать паузу
 pay=платить, плата
 payment=оплата, платеж
 peace=мир, покой
 peaceful=мирный, спокойный
 pen=ручка
 pencil=карандаш
 people=люди
 pepper=перец, перчить
 per=из расчета на, в
 perfect=идеальный, совершенный
 perform=исполнять, выполнять
 performance=исполнение, выступление
 perhaps=может быть, возможно
 period=период, срок
 permanent=постоянный, перманентный
 permission=разрешение, позволение
 person=человек, личность
 personal=личный, персональный
 persuade=убеждать
 pet=домашнее животное, ласкать
 phone=телефон, звонить по телефону
 photograph=фотографировать, фотография
 phrase=фраза, выражение
 physical=физический, материальный
 piano=пианино, фортепьяно
 pick=собирать, выбирать, выбор
 picture=картинка, рисунок, изобразить
 piece=часть, кусок
 pig=свинья
 pile=куча, груда, складывать
 pilot=пилот, летчик, пилотировать
 pin=булавка, приколоть
 pink=розовый, розовый цвет
 pipe=труба, трубка
 pity=жалость
 place=место, помещать
 plain=равнина, простой
 plan=план, проект, планировать
 plane=самолет, плоскость, плоский
 plant=растение, завод, сажать
 plastic=пластик, пластмасса, пластиковый
 plate=тарелка, пластинка
 play=играть, игра
 player=игрок, плеер
 pleasant=приятный
 please=пожалуйста, радовать
 pleasure=удовольствие
 plenty=достаточно, много, множество
 plural=множественный, множественное число
 pocket=карман
 poem=стихотворение
 poetry=поэзия, стихи
 point=точка, момент, указывать
 poison=яд, отравлять
 poisonous=ядовитый
 pole=столб, шест
 police=полиция, полицейские
 polish=полировать, наводить лоск, полировка
 polite=вежливый
 political=политический
 politician=политик
 politics=политика
 pool=бассейн, лужа
 poor=бедный
 popular=популярный
 population=население, жители
 port=порт
 position=положение, позиция
 positive=позитивный, положительный
 possess=владеть, обладать
 possession=владение, собственность
 possibility=возможность, вероятность
 possible=возможный, вероятный
 possibly=возможно, может быть
 post=почта, пост, вывешивать
 pot=горшок, кастрюля
 potato=картофель
 pound=фунт (453,6 г), фунт стерлингов
 pour=лить(ся), наливать
 powder=порошок, пудра
 power=сила, мощь, питать энергией
 powerful=мощный, сильный
 practical=практичный, практический
 practice=практика, практиковаться
 praise=похвала, хвалить
 pray=молить(ся)
 prayer=молитва, мольба
 prefer=предпочитать
 preparation=подготовка
 prepare=готовить, подготавливать
 present=настоящее время, текущий момент, настоящий
 preserve=сохранять, хранить
 president=президент, председатель
 press=нажимать, давить, пресса
 pressure=давление
 pretend=притворяться
 pretty=симпатичный, хорошенький, довольно
 prevent=предотвращать
 previous=предыдущий
 previously=ранее, заранее
 price=цена, оценивать
 priest=священник, жрец
 prince=принц, князь
 principle=принцип
 print=печать, отпечаток, печатать
 prison=тюрьма
 prisoner=заключенный
 private=частный, личный
 prize=приз
 probably=вероятно, наверное
 problem=проблема, проблемный
 process=процесс, подвергать процессу
 produce=производить, выпускать, изделие
 product=продукт, продукция
 production=производство, продукция
 profession=профессия
 professional=профессиональный, профессионал
 profit=прибыль, выгода
 program=программа, программировать
 progress=прогресс, движение вперед, развиваться
 promise=обещание, обещать
 pronounce=произносить
 pronunciation=произношение
 proof=доказательство, непроницаемый
 property=собственность, имущество
 proposal=предложение
 protect=защищать, охранять
 protection=защита
 protest=протест, протестовать
 proud=гордый
 prove=доказывать
 provide=снабжать, предоставлять
 public=общественный, народный, публика
 pull=тянуть
 pump=насос, помпа
 punish=наказывать
 punishment=наказание
 pure=чистый
 purple=фиолетовый, пурпурный, пурпур
 purpose=цель, назначение
 push=толкать, жать, толчок
 put=класть, ставить
 quality=качество
 quantity=количество
 quarrel=ссора, спор, ссориться
 quarter=четверть, квартал
 queen=королева
 question=вопрос, спрашивать
 quick=быстрый, быстро
 quickly=быстро
 quiet=тихий, тишина
 quite=вполне, совершенно
 race=гонка, заезд, участвовать в гонках
 radio=радио
 railroad=железная дорога
 rain=дождь, идти (о дожде)
 raise=повышать, поднимать, увеличение
 range=диапазон, спектр
 rank=ранг, звание, ранжировать
 rapid=быстрый, скорый
 rare=редкий
 rate=показатель чего-л., ставка, присваивать рейтинг
 rather=скорее, лучше
 raw=сырой, необработанный
 reach=достигать, добираться, охват
 react=реагировать
 reaction=реакция
 read=читать, чтение
 ready=готовый
 real=реальный, подлинный, реально
 realize=реализовать, понимать
 really=действительно, в самом деле
 reason=причина, повод, рассуждать
 reasonable=разумный
 receive=получать
 recent=недавний, последний
 recently=недавно
 recognize=распознавать, признавать
 recommend=рекомендовать
 record=запись, регистрация, записывать
 red=красный, красный цвет
 reduce=уменьшить, сокращать
 reduction=сокращение, снижение
 reflect=отражать, размышлять
 refusal=отказ
 refuse=отказывать(ся)
 regard=уважение, отношение, уважать
 region=регион, область
 regular=регулярный
 relate=соотносить(ся), иметь отношение
 related=связанные
 relation=связь, отношение
 relationship=взаимоотношение, отношение
 relative=родственник, относительный
 relax=расслаблять(ся)
 religion=религия
 religious=религиозный, верующий
 remain=оставаться в каком-л. состоянии
 remark=замечание, высказывание, замечать
 remember=помнить, вспоминать
 remind=напоминать
 remove=удалять, убирать
 rent=аренда, арендовать
 repair=ремонтировать, чинить, ремонт
 repeat=повторять
 replace=заменять, замещать
 reply=ответ, отвечать
 report=доклад, сообщение, сообщать
 represent=представлять, изображать
 representative=представитель, представительный
 request=просьба, запрос, просить
 require=требовать, нуждаться
 research=исследование, исследовать
 respect=уважение, уважать
 response=ответ, отклик
 responsible=ответственный
 rest=отдых, сон, отдыхать
 restaurant=ресторан
 restrict=ограничивать
 result=результат, следовать
 return=возвращать, возвращаться, возвращение
 reward=награда, вознаграждение, вознаграждать
 rice=рис
 rich=богатый
 rid=(+ of) освобождать, избавлять
 ride=ездить, кататься, езда
 right=правый, правильный, право
 ring=кольцо, звон, звонить
 rise=подниматься, восходить, рост
 risk=риск, рисковать
 river=река
 road=дорога, путь
 rob=грабить
 rock=камень, скала
 role=роль
 roll=катить(ся), вращать(ся), рулон
 romantic=романтический, романтичный
 roof=крыша
 room=комната, пространство
 root=корень
 rope=веревка, канат
 rough=грубый, шероховатый
 round=круглый, вокруг
 row=ряд, строка, грести
 royal=королевский, царский
 rub=тереть(ся)
 rubber=резина, каучук, резиновый
 rude=грубый, невежливый
 ruin=разрушать, губить, руины
 rule=правило, править
 ruler=правитель, линейка
 run=бежать, бегать, бег
 rush=торопить(ся), мчаться, спешка
 sad=грустный, печальный
 safe=безопасный, надежный, сейф
 safety=безопасность
 sail=плавать (под парусом), совершать плавание, парус
 salary=зарплата, оклад
 sale=продажа, распродажа
 salt=соль, солить
 same=тот (же) самый, такой же, то же
 sand=песок
 satisfaction=удовлетворение
 satisfy=удовлетворять
 Saturday=суббота
 save=сохранять, спасать
 say=говорить, сказать
 scale=шкала, масштаб
 scatter=рассеивать(ся), разбрасывать
 scene=сцена, вид
 school=школа
 science=наука
 scientific=научный
 scientist=ученый
 scissors=ножницы
 screen=экран
 screw=винт, болт, завинчивать
 sea=море, морской
 search=поиск, искать
 season=сезон, время года
 seat=сиденье
 second=секунда, второй по счёту, второй
 secret=секрет, тайна, тайный
 secretary=секретарь
 security=безопасность, защита
 see=видеть, смотреть
 seed=семя, семечко
 seek=искать, разыскивать
 seem=казаться, представляться
 sell=продавать
 send=посылать
 sense=чувство, ощущение, чувствовать
 sensible=разумный, здравомыслящий
 sensitive=чувствительный
 sentence=предложение, приговор
 separate=отдельный, отделять
 September=сентябрь
 series=ряд, последовательность
 serious=серьезный
 seriously=серьезно, всерьез
 servant=слуга, прислуга
 serve=служить, обслуживать
 service=обслуживание, сервис
 set=ставить, устанавливать, комплект
 settle=урегулировать, улаживать
 seven=семь, семерка
 seventeen=семнадцать
 seventy=семьдесят, 70
 several=несколько, несколько
 severe=суровый, серьезный
 sew=шить, зашивать
 sex=секс, пол
 sexual=сексуальный, половой
 shade=тень, оттенок, затенять
 shadow=тень
 shake=трясти, встряска
 shall=образует будущее время, просьбу/предложение
 shame=позор, стыд, позорить
 shape=форма, придавать форму
 share=делить, разделять, доля
 sharp=острый, резкий, резко
 she=она
 sheep=овца, баран
 sheet=лист, простыня
 shelf=полка
 shell=раковина, скорлупа
 shelter=приют, укрытие, приютить
 shine=светить(ся), сиять
 shiny=солнечный, блестящий
 ship=корабль, судно
 shirt=рубашка
 shock=удар, шок, шокировать
 shoe=ботинок, туфля
 shoot=стрелять
 shop=магазин, совершать покупки
 short=короткий, коротко
 shot=выстрел, кадр
 should=должен
 shoulder=плечо
 shout=кричать, крик
 show=показывать, шоу
 shut=закрывать(ся), запирать(ся)
 shy=стеснительный, застенчивый
 sick=больной
 side=сторона, боковой
 sight=зрение, вид
 sign=знак, подпись, подписывать
 signal=сигнал, сигнализировать
 significant=значительный, существенный
 silence=тишина, молчание
 silent=тихий, бесшумный
 silk=шелк
 silly=глупый
 silver=серебро, серебряный
 similar=похожий, сходный
 simple=простой, несложный
 since=с, с тех пор
 sincere=искренний
 sing=петь
 single=один, единственный, холостяк
 singular=единственный, исключительный, единственное число
 sink=тонуть, раковина
 sister=сестра
 sit=сидеть
 situation=ситуация
 six=шесть
 sixteen=шестнадцать
 sixty=шестьдесят, 60
 size=размер
 skill=умение, навык
 skillful=искусный, умелый
 skin=кожа, шкура
 skirt=юбка
 sky=небо
 sleep=спать, сон
 slide=скользить
 slight=незначительный, небольшой
 slip=скользить, проскальзывать
 slope=склон, наклон
 slow=медленный, замедлять(ся)
 small=маленький, небольшой
 smart=умный, элегантный
 smell=запах, обоняние, пахнуть
 smile=улыбаться, улыбка
 smoke=дым, курить
 smooth=гладкий, плавный
 snake=змея
 snow=снег, идти (о снеге)
 so=так, настолько, так что
 soap=мыло
 social=общественный, социальный, собрание
 society=общество
 sock=носок
 soft=мягкий
 soil=почва, земля, пачкать(ся)
 soldier=солдат
 solid=твердый, сплошной
 solution=решение
 solve=решать, разрешать
 some=некоторое количество, некоторые
 somebody=кто-то, кто-нибудь
 somehow=как-то, так или иначе
 someone=кто-то, кто-нибудь
 something=кое-что, нечто
 sometimes=иногда, временами
 somewhere=где-то, куда-то
 son=сын
 song=песня, пение
 soon=скоро, вскоре
 sore=больной, болезненный, больное место
 sorry=извините, сожалеющий
 sort=тип, вид, сортировать
 soul=душа
 sound=звучать, звук
 soup=суп
 sour=кислый
 source=источник
 south=юг, южный
 southern=южный
 space=пространство, космос, оставлять промежутки
 speak=говорить
 special=специальный, особый
 specific=конкретный, определенный
 speech=речь
 speed=скорость, ускорять
 spell=произносить по буквам, писать по буквам, заклинание
 spend=тратить, расходовать
 spin=крутить(ся), вращать(ся), кружение
 spirit=дух
 split=расщеплять(ся), разбивать на части, расщепление
 spoil=портить(ся), баловать
 spoon=ложка
 sport=спорт, вид спорт
 spot=пятно, место
 spread=распространять(ся), простирать(ся), распространение
 spring=весна, пружина, пружинить
 square=квадрат, площадь, квадратный
 stage=этап, стадия
 stair=ступенька
 stamp=штамп, печать, штамповать
 stand=стоять, стойка
 standard=стандартный, обычный, стандарт
 star=звезда, звездный
 start=начало, старт, начинать
 state=состояние, государство, заявлять
 statement=заявление, утверждение
 station=станция, пункт
 stay=останавливаться, оставаться, пребывание
 steady=устойчивый, постоянный
 steal=воровать, красть
 steam=пар
 steel=сталь
 steep=крутой
 step=шаг, ступать
 stick=приклеивать(ся), липнуть, палка
 stiff=жесткий, тугой
 still=по-прежнему, ещё
 sting=жалить, жало
 stomach=живот, желудок
 stone=камень
 stop=остановка, прекращение, останавливаться
 store=хранить, накапливать, магазин
 storm=буря, гроза
 story=рассказ, история
 straight=прямой, прямо
 strange=странный, чужой, незнакомый
 stranger=незнакомец, посторонний
 strategy=стратегия
 stream=поток
 street=улица
 strength=сила
 stretch=тянуть(ся), растягивать(ся)
 strict=строгий
 strike=ударять, бить, удар
 string=струна, веревка
 strong=сильный
 structure=структура, строение, структурировать
 struggle=делать усилия, бороться, усилие
 student=студент
 study=изучать, исследовать, изучение
 stupid=глупый
 style=стиль
 subject=тема, предмет
 substance=вещество, субстанция
 succeed=преуспевать, иметь успех
 success=успех
 successful=успешный, преуспевающий
 such=такой, подобный, такой
 suck=сосать
 sudden=внезапный
 suddenly=вдруг, внезапно
 suffer=страдать
 sugar=сахар
 suggest=предлагать, советовать
 suit=костюм, устраивать
 suitable=подходящий
 suitcase=чемодан
 sum=сумма
 summer=лето
 sun=солнце
 Sunday=воскресенье
 supply=поставка, снабжение, поставлять
 support=поддержка, поддерживать
 suppose=полагать, предполагать
 sure=конечно, уверенный
 surface=поверхность
 surprise=сюрприз, удивление, удивлять
 surround=окружать
 swallow=глотать, глоток
 swear=клясться, ругаться, клятва
 sweep=мести, подметать
 sweet=сладкий, сладкое
 swell=распухать, набухать
 swim=плавать, плыть, плавание
 swing=качать(ся), размахивать, качание, взмах
 sympathetic=сочувствующий, благожелательный
 sympathy=симпатия, сочувствие
 system=система, устройство
 table=стол, таблица, класть на стол
 tail=хвост
 take=брать, взять, получать
 talk=говорить, разговаривать, разговор
 tall=высокий
 task=задача, задание
 taste=вкус, иметь вкус
 tax=налог, пошлина, облагать налогом
 taxi=такси
 tea=чай
 teach=учить, обучать
 teacher=учитель
 team=команда, объединяться в команду
 tear=рвать(ся), разрывать(ся), слеза
 technical=технический
 telephone=телефон, звонить по телефону
 television=телевидение, телевизор
 tell=говорить, рассказывать
 temperature=температура
 temporary=временный
 ten=десять, десятка
 tend=иметь тенденцию, тяготеть
 tendency=тенденция, склонность
 tennis=теннис
 tense=напряженный, натянутый, грамматическое время
 tent=палатка
 term=срок, термин, называть
 terrible=ужасный
 test=тест, испытание, тестировать
 than=чем, нежели
 thank=благодарить
 thanks=спасибо, благодарность
 that=тот, та, что
 the=определенный артикль
 theater=театр
 themselves=сами, себя
 then=тогда, затем
 there=там, туда
 therefore=поэтому, следовательно
 they=они
 thick=толстый, плотный
 thief=вор
 thin=тонкий, худой, тонко
 thing=вещь, предмет
 think=думать
 third=третий, треть
 thirteen=тринадцать
 thirty=тридцать
 this=этот, это
 thorough=тщательный, полный
 though=хотя, несмотря на, тем не менее
 thought=мысль
 thousand=тысяча, тысяча
 thread=нить
 threat=угроза
 threat=угроза
 threaten=угрожать
 three=три
 throat=горло
 through=через, сквозь, насквозь
 throw=бросать, кидать, бросок
 thumb=большой палец руки
 Thursday=четверг
 thus=таким образом, поэтому
 ticket=билет, талон
 tie=завязывать, связывать, галстук
 tight=тугой, тесный
 time=время
 tire=шина, утомлять(ся)
 tired=уставший
 tiring=утомительный, изнурительный
 title=название, заглавие
 to=пространственные значения
 tobacco=табак
 today=сегодня, сегодняшний день
 toe=палец ноги, носок
 together=вместе
 toilet=туалет
 tomorrow=завтра, завтрашний день
 tongue=язык
 tonight=сегодня вечером, сегодня ночью, сегодняшний вечер
 too=слишком, тоже
 tool=инструмент, орудие
 tooth=зуб
 top=верхний, вершина
 total=весь, полный, сумма
 touch=прикасаться, трогать, прикосновение
 tourist=турист
 toward=к, по направлению к
 tower=башня
 town=город, городок
 toy=игрушка
 track=следить, отслеживать, след
 trade=торговля, торговать
 tradition=традиция
 traditional=традиционный
 traffic=трафик, движение
 train=поезд, тренировать(ся)
 training=подготовка, обучение
 translate=переводить
 trap=ловушка, ловить в ловушку
 travel=путешествовать, путешествие
 treat=относиться, обращаться
 treatment=лечение, обработка
 tree=дерево
 trial=суд, судебное разбирательство, пробный
 trick=трюк, уловка, обманывать
 trip=поездка, путешествие, спотыкаться
 tropical=тропический
 trouble=беспокойство, неприятность, беспокоить
 truck=грузовик
 true=истинный, верный, правдиво
 trust=вера, доверие, верить
 truth=правда, истина
 try=пытаться, стараться, попытка
 tube=труба, трубка
 Tuesday=вторник
 tune=мелодия
 turn=поворачивать, поворачиваться, поворачивание
 TV=телевидение, телевизор
 twelve=двенадцать
 twenty=двадцать
 twice=дважды
 twist=крутить, скручивать, поворот
 two=два
 type=тип, вид, печатать
 typical=типичный
 ugly=уродливый, безобразный
 uncle=дядя
 under=под
 understand=понимать
 undo=расстегивать, развязывать
 uniform=униформа, равномерный
 union=союз, объединение
 unit=часть, единица
 unite=объединять(ся)
 universe=вселенная
 university=университет
 unless=если не, пока не
 until=до, до тех пор пока
 up=вверх
 upon=на
 upper=верхний
 upset=огорчать, расстраивать, расстроенный
 upstairs=наверху, вверх по лестнице
 urgent=срочный, неотложный
 use=использовать, употребление
 useful=полезный
 useless=бесполезный
 usual=обычный
 usually=обычно
 vacation=отпуск, каникулы
 valley=долина
 valuable=ценный
 value=ценность, значение, ценить
 variety=разнообразие
 various=различный
 vegetable=овощ
 vehicle=автомобиль, транспортное средство
 verb=глагол
 very=очень, самый
 victim=жертва
 victory=победа
 view=вид, взгляд, обозревать
 village=деревня
 violence=насилие, жестокость
 violent=жестокий, насильственный
 visit=посещать, навещать, посещение
 voice=голос, произносить
 vote=голосовать, голосование
 vowel=гласный звук
 waist=талия
 wait=ждать, ожидание
 wake=проснуться, будить
 walk=идти, ходить, ходьба
 wall=стена
 want=хотеть, желать
 war=война
 warm=теплый, греть(ся)
 warmth=тепло, теплота
 warn=предупреждать
 warning=предупреждение
 wash=мыть(ся)
 waste=растрачивать, тратить впустую, растрата
 watch=смотреть, наблюдать, часы
 water=вода
 wave=волна, махать
 way=путь, направление
 we=мы
 weak=слабый
 wealth=богатство
 weapon=оружие
 wear=носить
 weather=погода
 web=сеть, паутина
 wedding=свадьба
 Wednesday=среда
 week=неделя
 weigh=весить, взвешивать(ся)
 weight=вес
 welcome=добро пожаловать, приветствовать
 well=хорошо, вполне, хороший
 west=запад, западный
 western=западный, вестерн
 wet=мокрый, влажный
 what=что
 whatever=что бы ни, все что, любой
 wheel=колесо
 when=когда, когда
 whenever=когда бы ни, всякий раз когда
 where=где, где
 whether=ли, который из двух
 which=который
 while=пока, в то время как, промежуток времени
 whisper=шептать(ся)
 white=белый, белый цвет
 who=кто
 whole=целый, весь, целое
 whom=кого
 whose=чей, чьё
 why=почему
 wide=широкий, широко
 width=ширина
 wife=жена
 wild=дикий
 will=образует будущее время
 will=воля, желание
 willing=готовый (сделать что-л.)
 win=победить, выиграть, победа
 wind=ветер
 window=окно
 wine=вино
 wing=крыло
 winter=зима
 wire=провод, проволока
 wise=мудрый
 wish=желать, желание
 with=с, вместе с
 within=внутри, в рамках
 without=без
 woman=женщина
 wonder=удивляться, интересоваться, удивление
 wood=дерево, (мн.) лес
 wooden=деревянный
 wool=шерсть
 word=слово
 work=работа, работать
 worker=рабочий
 world=мир
 worry=беспокоиться, волноваться, беспокойство
 worse=хуже, худший
 worst=наихудший, наихудшее
 worth=стоящий, стоимость
 would=выражает условное наклонение
 wound=рана, ранить
 wrap=заворачивать, обертывать
 wrist=запястье
 write=писать
 writer=писатель
 wrong=неправильный, ошибочный, неправильно
 yard=ярд (91,44 см), двор
 year=год
 yellow=желтый, желтый цвет
 yes=да, утвердительный ответ
 yesterday=вчера, вчерашний день
 yet=еще, все еще, тем не менее
 you=ты, вы
 young=юный, молодой, молодёжь
 yourself=себя, себе
 zero=ноль
